# map3 remap grid generated from gray tiles + enclosed regions
# width=128 height=128
00000000000000000000000000000000000000000000000000000000000000000000000000000000000000000000000000000000000000000000000000000000
00000000000000000000000000000000000000000000000000000000000000000000000000000000000000000000000000000000000000000000000000000000
00000000000000000000000000000000000000000000000000000000000000000000000000000000000000000000000000000000000000000000000000000000
00000000000000000000111111111111000000000000000000000000000000000000000000000000000000000000000000000000000000000000000000000000
00000000000000000011111111111111110000000000000000000000000000000000000000000000000000000000000000011111100000000000000000000000
00000000000000001111111111111111111100000000000000000000000000000000000000000000000000000011111111111111111101000000000000000000
00000000000000111111111111111111111111000000000000000000000000000000000000000000000000001111111111111111111111110000000000000000
00000000000001111111111111111111111111110000000000000000000000000000000000000000000000111111111111111111111111111000000000000000
00000000000011111111111111111111111111111000000000000000000000000000000000000000000011111111111111111111111111111100000000000000
00000000000111111111111111111111111111111100000000000000000000000000000000000000000111111111111111111111111111111110000000000000
00000000001111111111111111111111111111111110000000000000000000000000000000000000001111111111111111111111111111111111000000000000
00000000011111111111111111111111111111111111000000000000000000000000000000000000011111111111111111111111111111111111100000000000
00000000011111111111111111111111111111111111000000000000000000000000000000000000011111111111111111111111111111111111110000000000
00000000111111111111111111111111111111111111100000000000000000000000000000000000111111111111111110000111111111111111110000000000
00000000111111111111111110000111111111111111100000000000000000000000000000000000111111111111110000000000011111111111111000000000
00000001111111111111110000000000111111111111110000000000000000000000000000000000111111111111000000000000000111111111111000000000
00000001111111111111000000000000001111111111110000000000000000000000000000000001111111111110000000000000000011111111111100000000
00000001111111111110000000000000000011111111111000000000000000000000000000000001111111111100000000000000000001111111111100000000
00000011111111111100000000000000000001111111111000000000000000000000000000000001111111111000000000000000000000111111111110000000
00000011111111111000000000000000000001111111111100000000000000000000000000000001111111111000000000000000000000011111111110000000
00000011111111111000000000000000000000111111111100000000000000000000000000000011111111110000000000000000000000011111111111000000
00000011111111110000000000000000000000111111111110000000000000000000000000000011111111110000000000000000000000001111111111000000
00000111111111110000000000000000000000011111111110000000000000000000000000000011111111100000000000000000000000001111111111000000
00000111111111100000000000000000000000011111111111000000000000000000000000000011111111100000000000000000000000000111111111100000
00000111111111100000000000000000000000001111111111000000000000000000000000000111111111100000000000000000000000000111111111100000
00000111111111100000000000000000000000001111111111100000000000000000000000000111111111100000000000000000000000000011111111100000
00000111111111100000000000000000000000000111111111100000000000000000000000000111111111000000000000000000000000000011111111100000
00000111111111100000000000000000000000000111111111110000000000000000000000000111111111000000000000000000000000000011111111100000
00000111111111100000000000000000000000000011111111110000000000000000000000001111111111000000000000000000000000000001111111100000
00000111111111100000000000000000000000000011111111111000000000000000000000001111111111000000000000000000000000000001111111100000
00000111111111100000000000000000000000000001111111111000000000000000000000001111111110000000000000000000000000000001111111100000
00000111111111100000000000000000000000000001111111111100000000000000000000011111111110000000000000000000000000000001111111100000
00000111111111100000000000000000000000000000111111111100000000000000000000011111111110000000000000000000000000000001111111100000
00000111111111100000000000000000000000000000111111111111000000000000000000111111111110000000000000000000000000000001111111100000
00000111111111100000000000000000000000000000011111111111111111111111111111111111111100000000000000000000000000000001111111100000
00000111111111100000000000000000000000000000011111111111111111111111111111111111111100000000000000000000000000000001111111100000
00000111111111100000000000000000000000000000001111111111111111111111111111111111111100000000000000000000000000000001111111100000
00000111111111100000000000000000000000000000001111111111111111111111111111111111111000000000000000000000000000000001111111100000
00000111111111100000000000000000000000000000000111111111111111111111111111111111110000000000000000000000000000000011111111100000
00000111111111100000000000000000000000000000000011111111111111111111111111111111100000000000000000000000000000000011111111100000
00000111111111100000000000000000000000000000000001111111111111111111111111111111000000000000000000000000000000000011111111100000
00000111111111100000000000000000000000000000000000111111111111111111111111111110000000000000000000000000000000000111111111100000
00000111111111100000000000000000000000000000000000001111111111111111111111111000000000000000000000000000000000000111111111000000
00000111111111100000000000000000000000000000000000000000000000000000000000000000000000000000000000000000000000000111111111000000
00000111111111100000000000000000000000000000000000000000000000000000000000000000000000000000000000000000000000000111111111000000
00000111111111100000000000000000000000000000000000000000000000000000000000000000000000000000000000000000000000001111111111000000
00000111111111100000000000000000000000000000000000000000000000000000000000000000000000000000000000000000000000001111111110000000
00000111111111100000000000000000000000000000000000000000000000000000000000000000000000000000000000000000000000011111111110000000
00000111111111100000000000000000000000000000000000000000000000000000000000000000000000000000000000000000000011111111111110000000
00000111111111100000000000000000000000000000000000000000000000000000000000000000000000000000000000000000111111111111111100000000
00000111111111100000000000000000000000000000000000000000000000000000000000000000000000000000000000001111111111111111111100000000
00000111111111100000000000000000000000000000000000000000000000000000000000000000000000000000000011111111111111111111111000000000
00000111111111100000000000000000000000000000000000000000000000000000000000000000000000000000111111111111111111111111110000000000
00000000000000000000000000000000000000000000000000000000000000000000000000000000000000001111111111111111111111111111100000000000
00000111111111100000000000000000000000000000000000000000000000000000000000000000000011111111111111111111111111111111000000000000
00000111111111100000000000000000000000000000000000000000000000000000000000000000111111111111111111111111111111111100000000000000
00000111111111100000000000000000000000000000000000000000000000000000000000001111111111111111111111111111111111110000000000000000
00000111111111100000000000000000000000000000000000000000000000000000000011111111111111111111111111111111111100000000000000000000
00000111111111100000000000000000000000000000000000000000000000000000111111111111111111111111111111111111000000000000000000000000
00000111111111100000000000000000000000000000000000000000000000001111111111111111111111111111111111110000000000000000000000000000
00000111111111100000000000000000000000000000000000000000000011111111111111111111111111111111111100000000000000000000000000000000
00000111111111100000000000000000000000000000000000000000111111111111111111111111111111111111000000000000000000000000000000000000
00000111111111100000000000000000000000000000000000001111111111111111111111111111111111110000000000000000000000000000000000000000
00000111111111100000000000000000000000000000000011111111111111111111111111111111111100000000000000000000000000000000000000000000
00000111111111100000000000000000000000000000001111111111111111111111111111111111000000000000000000000000000000000000000000000000
00000111111111100000000000000000000000000000111111111111111111111111111111110000000000000000000000000000000000000000000000000000
00000111111111100000000000000000000000000011111111111111111111111111111100000000000000000000000000000000000000000000000000000000
00000111111111100000000000000000000000000111111111111111111111111111000000000000000000000000000000000000000000000000000000000000
00000111111111100000000000000000000000000111111111111111111111110000000000000000000000000000000000000000000000000000000000000000
00000111111111100000000000000000000000000111111111111111111100000000000000000000000000000000000000000000000000000000000000000000
00000111111111100000000000000000000000001111111111111111110000000000000000000000000000000000000000000000000000000000000000000000
00000111111111100000000000000000000000001111111111111111000000000000000000000000000000000000000000000000000000000000000000000000
00000111111111100000000000000000000000001111111111111100000000000000000000000000000000000000000000000000000000000000000000000000
00000111111111100000000000000000000000001111111111111100000000000000000000000000000000000000000000000000000000000000000000000000
00000111111111100000000000000000000000001111111111111111110000000000000000000000011111111111111111111110000000000000000000000000
00000111111111100000000000000000000000001111111111111111111111111111111111111111111111111111111111111111111111000000000000000000
00000111111111100000000000000000000000001111111111111111111111111111111111111111111111111111111111111111111111110000000000000000
00000111111111100000000000000000000000001111111111111111111111111111111111111111111111111111111111111111111111111100000000000000
00000111111111100000000000000000000000000111111111111111111111111111111111111111111111111111111111111111111111111111000000000000
00000111111111100000000000000000000000000111111111111111111111111111111111111111111111111111111111111111111111111111100000000000
00000111111111100000000000000000000000000111111111111111111111111111111111111111111111111111111111111111111111111111110000000000
00000111111111100000000000000000000000000011111111111111111111111111111111111111111111111111111111111111111111111111111000000000
00000111111111100000000000000000000000000001111111111111111111111111111111111111111111111111111111111111111111111111111100000000
00000111111111100000000000000000000000000000111111111111111111111111000000000000000000000000000000000000111111111111111110000000
00000111111111100000000000000000000000000000001111111111111111111111000000000000000000000000000000000000000111111111111110000000
00000111111111100000000000000000000000000000000000000000000000000000000000000000000000000000000000000000000001111111111111000000
00000111111111100000000000000000000000000000000000000000000000000000000000000000000000000000000000000000000000011111111111000000
00000111111111100000000000000000000000000000000000000000000000000000000000000000000000000000000000000000000000001111111111000000
00000111111111100000000000000000000000000000000000000000000000000000000000000000000000000000000000000000000000000111111111100000
00000111111111100000000000000000000000000000000000000000000000000000000000000000000000000000000000000000000000000111111111100000
00000111111111100000000000000000000000000000000000000000000000000000000000000000000000000000000000000000000000000011111111100000
00000111111111100000000000000000000000000000000000000000000000000000000000000000000000000000000000000000000000000011111111100000
00000111111111100000000000000000000000000000000000000000000000000000000000000000000000000000000000000000000000000011111111100000
00000111111111100000000000000000000000000000000000000000000000000000000000000000000000000000000000000000000000000011111111100000
00000111111111100000000000000000000000000000000000000000000000000000000000000000000000000000000000000000000000000011111111100000
00000111111111100000000000000000000000000000000000000000000000000000000000000000000000000000000000000000000000000001111111100000
00000111111111100000000000000000000000000000000000000000000000000000000000000000000000000000000000000000000000000001111111100000
00000011111111100000000000000000000000000000000000000000000000000000000000000000000000000000000000000000000000000001111111100000
00000011111111100000000000000000000000000000000000000000001111111111111111110000000000000000000000000000000000000001111111100000
00000011111111100000000000000000000000000000000000000000111111111111111111111100000000000000000000000000000000000001111111100000
00000011111111100000000000000000000000000000000000000001111111111111111111111111000000000000000000000000000000000001111111100000
00000011111111100000000000000000000000000000000000000011111111111111111111111111100000000000000000000000000000000001111111100000
00000001111111110000000000000000000000000000000000000111111111111111111111111111100000000000000000000000000000000011111111100000
00000001111111110000000000000000000000000000000000001111111111111111111111111111100000000000000000000000000000000011111111100000
00000001111111110000000000000000000000000000000000011111111111111111111111111111110000000000000000000000000000000011111111100000
00000001111111110000000000000000000000000000000000111111111111111111111111111111110000000000000000000000000000000111111111000000
00000000111111111000000000000000000000000000000001111111111111000000001111111111110000000000000000000000000000000111111111000000
00000000111111111000000000000000000000000000000011111111111110000000000111111111110000000000000000000000000000001111111111000000
00000000111111111000000000000000000000000000000111111111111100000000000011111111110000000000000000000000000000011111111110000000
00000000111111111100000000000000000000000000001111111111110000000000000011111111110000000000000000000000000001111111111110000000
00000000011111111100000000000000000000000000011111111111100000000000000001111111111000000000000000000000000111111111111100000000
00000000011111111110000000000000000000000000111111111111000000000000000001111111111000000000000000000001111111111111111100000000
00000000011111111110000000000000000000000001111111111110000000000000000001111111111111000000000000011111111111111111111000000000
00000000011111111111000000000000000000000011111111111100000000000000000001111111111111111111111111111111111111111111111000000000
00000000001111111111000000000000000000001111111111111000000000000000000000111111111111111111111111111111111111111111110000000000
00000000001111111111110000000000000000111111111111110000000000000000000000111111111111111111111111111111111111111111100000000000
00000000000111111111111000000000001111111111111111100000000000000000000000111111111111111111111111111111111111111111000000000000
00000000000111111111111111011111111111111111111111000000000000000000000000011111111111111111111111111111111111111100000000000000
00000000000011111111111111111111111111111111111110000000000000000000000000001111111111111111111111111111111111110000000000000000
00000000000011111111111111111111111111111111111100000000000000000000000000000111111111111111111111111111111111000000000000000000
00000000000001111111111111111111111111111111111000000000000000000000000000000001111111111111111111111111100000000000000000000000
00000000000000111111111111111111111111111111110000000000000000000000000000000000000000000000000000000000000000000000000000000000
00000000000000011111111111111111111111111111100000000000000000000000000000000000000000000000000000000000000000000000000000000000
00000000000000001111111111111111111111111110000000000000000000000000000000000000000000000000000000000000000000000000000000000000
00000000000000000011111111111111111111100000000000000000000000000000000000000000000000000000000000000000000000000000000000000000
00000000000000000000111111111111111000000000000000000000000000000000000000000000000000000000000000000000000000000000000000000000
00000000000000000000000000000000000000000000000000000000000000000000000000000000000000000000000000000000000000000000000000000000
00000000000000000000000000000000000000000000000000000000000000000000000000000000000000000000000000000000000000000000000000000000
